JONAS = Does this person likes Jonas Brothers?;
ANIME = Does this person watch anime?;
MARVEL = Does this person likes a Marvel Character?;
CAPTAIN = Does he/she likes Captain America?;
IRONMAN = Does this person likes Iron Man?;
DANCE = Does this person likes to dance?;
SING = Does this person likes to sing?;
GAMER = Is this person a gamer?;
REDDIT = Does this person visits Reddit a lot?;
9GAG = Does this person visits 9GAG a lot?;
KPOP = this person likes KPOP?;
ARROW = Does this person watches Arrow?;
BIGBANG = Does this person likes Bigbang Theory?;
F_ROCKBAND = Does this person likes a foreign rockband?;
J_ROCKBAND = Does this person likes J-Rock band?;
A_ROCKBAND = Does this person likes American rockbands?;
L_ROCKBAND = Does this person likes a local rockband?;
SCANDAL = Does this person likes the J-Rock band SCANDAL?;
1OKROCK = Does this person likes ONE OK ROCK?;
THESCRIPT = Does that person likes The Script?;
PNE = Does this person likes Parokya Ni Edgar?;
KAMIKAZEE = Does this person likes Kamikazee?;
INSTRUMENTS = Does this plays musical instruments?;
GUITAR = Does this person plays guitar?;
PIANO = Does this person plays piano/organ?;
PROGVAR = Is this person one of the Programming Varsity?;
REL_ORGS = Is this person a member of religious organization?;
WBC = Is this person a member of Women’s Basketball Club?;
TALL = Is this person tall?;
GIRL = Is this person a girl?;
BOY = Is this person a boy?;
DOGS = Is thsi person afraid of dogs?;
ORGS = Aside from UPCSG, is this person a member of another organization?;
INTEREST_ORGS = this person a member of an interest-based organization?;
SERENATA = Is this person a member of UP Serenata?;
SAYAWE = Is this person a member of UP Sayawe?;
UPSTAGE = Is this person a member of UPSTAGE?;
SPORTS_ORGS = Is this person a member of a sports-based organization?;
